27 27
W W W W W W W W W W W W W W W W W W W W W W W W W W W
W G O O O C O O O O O O E c O O O O O O O O O O e W W
W O O O O W O O O O O W W W W W O O O O O W W W W W W
W O O O O W O O O O O W O O O W O O O O O W O W O W W
W O O O O W O O O O O W O W O W O O O O O W O W O W W
W W W W W W O O O O O W O W O W O O O O O W O W O W W
W O O O O O O O O O O W O O O W O O O O O W O O O W W
W O O O O O O O O O O W W W W W O O O O O W W W W W W
W O O O O O O O O O O W O O O W O O O O O W O O O W W
W O O O O O O O O O O W O W W W O O p O O W O W W W W
W O O O O O O O O O O W O O O W O O O O O W O O O W W
W O O O O O O O O O O W O W W W O O O O O W O W W W W
W 0 O O O O O O O O O W O O O W O O O O O W O O O W W
W O O O O O O O O O O W W W W W O O O O O W W W W W W
W O O O O O O O O O O W O O O W O O D O O W W O W W W
W O O O O h O O O O O W O W W W O O O O O W O O O W W
W O O O O O O O O O O W O O O W O O O O O O O b O O W
W O O O O O O O O O O W O W W W O O O O O W W W W W W
W O O O O O O O O O O W O O O W O O p O O W O O G W W
W O O O O O O O O O O W W W W W O O O O O W O O O W W
W O O O O O O O O O O W W W W W O O O O O W O O O W W
W O O O O O O O O O O O W W W O O O O O O W O O O W W
W O O O O O O O O O O O O W O O O O O O O W w w w w W
W O O O O O O O O O O O O B O O O O O O O A h O O a W
W O O O O O O O O O O O O W O O O O O O O W O O O O W
W d O O O O O O O O O O W W W O O O O O O W p O O S W
W W W W W W W W W W W W W W W W W W W W W W W W W W W
