27 27
W W W W W W W W W W W W W W W W W W W W W W W W W W W
W G O O O D O O O O O O E c O W O O O O O O O O e W W
W O O O O W O O O O O W W W W W O O O O O W W W W W W
W O O O O W O O O O O W O O O W O O b O O W O W O W W
W O O O O W O O O O O W O W O W O O O O O W O W O W W
W W W W W W w w w W W W O W O W O O O O O W O W O W W
W O O O O O O O O O O W O O O W O O O O O W O O O W W
W O O O O O O O O O O W W W W W O O O O O W W W W W W
W O O O O O O O O O O W O O O W O O O O O W O O O W W
W O O O O O O O O O O W O W W W O O O O O W O W W W W
W O O O O O O O O O O W O O O W O O O O O W O O O W W
W O O O O O O O O O O W O W W W O O O O O W O W W W W
W O O O O O O O O O O W O O O W O O O O O W O O O W W
W O O O O O O O O O O W W W W W O O O O O W W W W W W
W O O O O O O O O O O W O O O W O O O O O W W O W W W
W O O O O O O O O O O W O W W W w w w w w W O O O W W
W O O O O O O O O O O W O O O W w w w w w O O O O O W
W O O O O O O O O O O W O W W W w w w w w W W W W W W
W O O O O O O O O O O W O O O W w w w w w W O O O W W
W w w w w w w w w w w W W W W W O O O O O W O O O W W
W O O O O O O O O O O W W W W W O O h O O W O O O W W
W O O O O O O O O O O O W W W O O O O O O W O O O W W
W O O O O O O O O O O O O W O O O O O O O W W W W W W
W O O O O O O O O O O O O B O O O O O O O A O O O a W
W O O O O O O O O O O O O W O O p O O O O W O O O O W
W d O O O O O O O O O O W W W O O O O O O W O O O S W
W W W W W W W W W W W W W W W W W W W W W W W W W W W
